R    1000 700
NO ./textures/1.xpm
SO    ./textures/2.xpm
WE ./textures/3.xpm
EA ./textures/4.xpm
S       ./textures/moemon.xpm

F 105,85,124
C 63,42,85


        1111111111111111111111111
        1000000000110000002000001
        1011000001110000000000001111
        1001002000000000020200000001
111111111011000001110000000000001111
100000000011000001110111100011111
11110111111111011100000010001
11110111111111011101010010001
11000000110101011120000000N01
10002000000000001100000010001
10000000020000000001010010001
1100000111010101111101111020111
11110111 1110101 101111010001
11111111 1111111 111111111111
